      #################
#######...............########
#............................############
#........##.............................#
#........##.............................#
#.......................................#
#.......................##..............#
#.......................##..............#
#.......................................#
#.......................................#
#.......................................#
#.......................................#
#........@.............................##
##..............##....................##
 #..............##....................# 
 #....................................# 
 #####...........................######
     #############################