#########################################
#.......................................E
#............................##########.#
#....@..................................#
#.......................................#
#.......................................#
#.......................................#
#.......................................#
#.......................................#
#.......................................#
#.......................................#
#.......................................#
#.......................................#
#.......................................#
#.......................................#
#.......................................#
#.......................................#
#.......................................#
#.................E.....................#
#.......................................#
#.......................................#
#.......................................#
#.......................................#
#.......................................#
#.......................................#
#.......................................#
#.......................................#
#.......................................#
#.......................................#
#.......................................#
#.......................................#
#.......................................#
#.......................................#
#.......................................#
#.......................................#
#.......................................#
#.......................................#
#########################################