######################
#.@..................#
#.##################.#
#.##################.#
#.##################.#
#.##################.#
#.##################.#
#.##################.#
#.##################.#
#.##################.#
#.##################.#
#.##################.#
#.##################.#
#.##################.#
#.##################.#
#.##################.#
#....................#
######################